//MAP CONVERTED BY dmm2tgm.py THIS HEADER COMMENT PREVENTS RECONVERSION, DO NOT REMOVE
"a" = (
/turf/closed/wall/mineral/wood/nonmetal,
/area/space)
"c" = (
/obj/structure/railing/wooden_fencing{
	dir = 1
	},
/turf/open/misc/dirt/icemoon,
/area/space)
"d" = (
/obj/structure/stairs/wood{
	dir = 1
	},
/obj/structure/railing/wooden_fencing{
	dir = 4
	},
/turf/closed/wall/mineral/wood/nonmetal,
/area/space)
"h" = (
/turf/open/misc/dirt/icemoon,
/area/space)
"j" = (
/obj/structure/stairs/wood{
	dir = 1
	},
/obj/structure/railing/wooden_fencing{
	dir = 8
	},
/turf/closed/wall/mineral/wood/nonmetal,
/area/space)
"k" = (
/obj/structure/stairs/wood,
/obj/structure/railing/wooden_fencing{
	dir = 8
	},
/turf/closed/wall/mineral/wood/nonmetal,
/area/space)
"q" = (
/obj/structure/mineral_door/wood/large_gate{
	dir = 1
	},
/turf/open/misc/dirt/icemoon,
/area/space)
"t" = (
/obj/structure/stairs/wood{
	dir = 4
	},
/turf/closed/wall/mineral/wood/nonmetal,
/area/space)
"u" = (
/turf/open/misc/asteroid/snow/icemoon,
/area/space)
"w" = (
/obj/structure/stairs/wood{
	dir = 4
	},
/obj/structure/stairs/wood{
	dir = 4
	},
/obj/structure/railing/wooden_fencing,
/turf/closed/wall/mineral/wood/nonmetal,
/area/space)
"x" = (
/obj/structure/stairs/wood{
	dir = 4
	},
/obj/structure/railing/wooden_fencing,
/turf/closed/wall/mineral/wood/nonmetal,
/area/space)
"B" = (
/turf/open/floor/wood/icemoon,
/area/space)
"D" = (
/obj/structure/railing/wooden_fencing{
	dir = 4
	},
/turf/open/misc/dirt/icemoon,
/area/space)
"I" = (
/obj/structure/stairs/wood{
	dir = 4
	},
/obj/structure/railing/wooden_fencing{
	dir = 1
	},
/turf/closed/wall/mineral/wood/nonmetal,
/area/space)
"J" = (
/obj/structure/stairs/wood{
	dir = 8
	},
/obj/structure/railing/wooden_fencing{
	dir = 1
	},
/turf/closed/wall/mineral/wood/nonmetal,
/area/space)
"M" = (
/turf/closed/wall/mineral/stone,
/area/space)
"O" = (
/obj/structure/railing/wooden_fencing{
	dir = 1
	},
/obj/structure/railing/wooden_fencing{
	dir = 8
	},
/turf/open/misc/dirt/icemoon,
/area/space)
"Q" = (
/obj/structure/stairs/wood{
	dir = 8
	},
/obj/structure/railing/wooden_fencing,
/turf/closed/wall/mineral/wood/nonmetal,
/area/space)
"W" = (
/obj/structure/railing/wooden_fencing{
	dir = 8
	},
/turf/open/misc/dirt/icemoon,
/area/space)
"X" = (
/obj/structure/mineral_door/wood/large_gate,
/turf/open/misc/dirt/icemoon,
/area/space)
"Y" = (
/obj/structure/stairs/wood,
/obj/structure/railing/wooden_fencing{
	dir = 4
	},
/turf/closed/wall/mineral/wood/nonmetal,
/area/space)
"Z" = (
/obj/structure/railing/wooden_fencing{
	dir = 1
	},
/obj/structure/railing/wooden_fencing{
	dir = 4
	},
/turf/open/misc/dirt/icemoon,
/area/space)

(1,1,1) = {"
u
u
u
u
u
u
u
u
u
u
u
u
u
u
u
u
u
u
u
u
"}
(2,1,1) = {"
u
u
u
u
M
M
u
u
u
u
u
u
u
u
M
M
u
u
u
u
"}
(3,1,1) = {"
u
u
a
M
M
M
M
a
a
a
a
a
a
M
M
M
M
a
u
u
"}
(4,1,1) = {"
u
u
a
u
J
Q
u
u
u
u
u
u
u
u
J
Q
u
a
u
u
"}
(5,1,1) = {"
u
u
a
u
u
u
u
u
u
u
u
O
W
W
h
h
u
a
u
u
"}
(6,1,1) = {"
u
u
a
u
u
u
u
u
u
u
u
c
h
h
h
h
u
a
u
u
"}
(7,1,1) = {"
u
u
a
u
u
u
u
u
u
u
u
O
W
W
h
h
u
a
u
u
"}
(8,1,1) = {"
u
u
M
u
u
u
u
u
u
u
u
c
h
h
h
h
u
M
u
u
"}
(9,1,1) = {"
u
M
M
j
u
u
u
h
u
u
u
O
W
W
h
h
k
M
M
u
"}
(10,1,1) = {"
u
M
M
d
u
u
h
h
u
u
u
c
h
h
h
h
Y
M
M
u
"}
(11,1,1) = {"
u
u
M
u
u
u
u
h
h
u
u
O
W
W
h
h
u
M
u
u
"}
(12,1,1) = {"
u
u
a
u
u
u
u
u
h
h
u
Z
D
D
h
h
u
a
u
u
"}
(13,1,1) = {"
u
u
a
u
u
u
u
u
h
h
h
h
h
h
h
h
h
a
u
u
"}
(14,1,1) = {"
u
u
a
u
u
u
u
u
h
h
h
h
h
h
h
h
h
a
u
u
"}
(15,1,1) = {"
u
u
X
u
u
u
u
u
h
h
h
h
h
h
h
h
h
X
u
u
"}
(16,1,1) = {"
u
u
q
u
u
u
u
u
h
h
h
h
h
h
h
h
h
q
u
u
"}
(17,1,1) = {"
u
u
a
u
u
u
u
u
h
h
h
h
h
h
h
h
h
a
u
u
"}
(18,1,1) = {"
u
u
a
u
u
u
u
h
h
u
u
u
h
h
u
u
u
a
u
u
"}
(19,1,1) = {"
u
u
a
u
u
u
u
u
h
h
u
u
h
u
u
u
u
a
u
u
"}
(20,1,1) = {"
u
u
M
u
u
u
u
h
h
u
u
h
h
h
u
u
u
M
u
u
"}
(21,1,1) = {"
u
M
M
j
u
u
u
h
h
u
a
u
h
a
u
u
k
M
M
u
"}
(22,1,1) = {"
u
M
M
d
u
u
u
u
h
u
a
B
B
a
u
u
Y
M
M
u
"}
(23,1,1) = {"
u
u
M
u
u
u
u
u
u
u
a
t
t
a
u
u
u
M
u
u
"}
(24,1,1) = {"
u
u
a
u
u
u
u
u
u
u
a
a
a
a
u
u
u
a
u
u
"}
(25,1,1) = {"
u
u
a
u
u
u
u
u
u
u
u
u
h
u
u
u
u
a
u
u
"}
(26,1,1) = {"
u
u
a
u
u
u
u
u
u
u
u
u
u
u
u
u
u
a
u
u
"}
(27,1,1) = {"
u
u
a
u
I
w
u
u
u
u
u
u
u
u
I
x
u
a
u
u
"}
(28,1,1) = {"
u
u
a
M
M
M
M
a
a
a
a
a
a
M
M
M
M
a
u
u
"}
(29,1,1) = {"
u
u
u
u
M
M
u
u
u
u
u
u
u
u
M
M
u
u
u
u
"}
(30,1,1) = {"
u
u
u
u
u
u
u
u
u
u
u
u
u
u
u
u
u
u
u
u
"}
